%%%%%%%%%%%%%%%%%%%%
%....%........%....%
%.%%.%.%%..%%.%.%%.%
%...... G GG%......%
%.%.%%.%% %%%.%%.%.%
%.%....% ...%.%..%.%
%.%.%%.% %% %.%.%%.%
%........P....%....%
%%%%%%%%%%%%%%%%%%%%
