%%%%%%%%%%%%%%%%%%%%%%%%%
%% %%  %%  %%     %% %%P%
%     %%  %%% %%%%%% %% %
%%% %%%%% % % %%% %  %  %
% % %% %          %%   %%
% % %% % %%%%%%%%%%% %%%%
% % %%      %% %  %    %%
%    %%% %%%%% %%   %%  %
%%% %%            %  %% %
%    %%%% %%% %% %%%  %%%
%%%% % %   %%%%%   %%%%%%
%%%%   %% %% % %%%%%%   %
%    %          % %%  %%%
% %%%%%% %%% %%      %% %
%%%%       %%%%%%%%%%%% %
%% %%% % % %% %%%%      %
%  %   % %         % %%%%
%% %% %%%%% %%% % %%    %
%         %  %%%%  %% % %
%%% %% % %%%   %%%%%% % %
%%   % % % % %  %%%%  % %
%  % % %   % %%    % %% %
%% % % %% %% %% %%%%%%%%%
%. % % %   % %%         %
%%%%%%%%%%%%%%%%%%%%%%%%%
