%%%%%%%%%%%%%%%
%  %G%.% % % P%
%% % % % % % %%
%  ..      . %%
% %%% % %% %  %
%%%%%%%%%  %% %
%  .%%    %%  %
% %....%%  %%%%
% %%%% G%%  %%%
% %    %%%%   %
%%%% % G .%%% %
%   .% % %%   %
%% % % % %% % %
%. % % % %% % %
%%%%%%%%%%%%%%%
